1111111111
1222222211
1222222311
122222111
122222221
111111111